10
10
0010001
####S#####
####8#####
####169###
######8###
##76663###
##8#######
##16669###
######8###
######D###
##########
