11
11
####S##########
####.##########
####...########
######.########
##.....########
##.############
##.....########
######.########
######.########
######D########
###############
