9
16
################
#S.............#
#.....####.....#
#S.............#
#......##.....D#
#S.............#
#.....####.....#
#S.............#
################
