9
16
################
#S............D#
#.....####....D#
#S............D#
#......##.....D#
#S............D#
#.....####....D#
#S............D#
################
