20
20
####|###############
####|########/--\###
####L-\######|##|###
######|#/-\##|##|###
##/---J#|#|##|##|###
##|####T|#|##|##|###
##L-----J#L--J##|###
################|###
#/-\######/-----J###
#|#|#/----J##########|#|#|########B#####
#|#|#|########B#####
#|#|T|#/---------\##
#|#L-J#|#########|##
#|####/J##/----\#|##
#|###/J###|####|#D##
#|###|#/--J####|####
#|###L-J#######|####
#L-\##/--------J####
###L--JT############
####################
