12
12
000001110201112
###S########
#763########
#8##########
#8##########
#8##########
#8##########
#8#######D69
#8#########8
#8#########8
#8#########8
#16666666663
############
