15
15
11111000222220101212121
###############
##########7S###
#########73####
########73#####
#######73######
######73#######
###7663########
###8###########
###16669#######
#######19######
########19#####
#########19####
##########16D##
###############
###############