10
10
##########
##########
##########
##########
....##....
###....###
##########
##########
##########
##########